 -1  -8   7  -9   8   4  -3  -9  -8  -1   9  -5   6   4  -9  -1  -8  -3 

  6  -9   9  -8   6   6  -2  -2  -6   1   7   6   2  -7   7  -3   9   5 

 -9  -3   2   9   2   2  -6  -5  -4  -9   3  -6  -6  -1  -8  -6   0   4 

  6   5  -8   9  -7   5   2   5   5  -1  -8   4  -8  -8  -9   3   7  -1 

 -8   8   3  -6   8  -4  -2   9   1  -1   9   8  -7   5   3  -9   1   5 

  2  -7   0  -6   1  -2   8  -1   0   5  -7  -3  -5  -9  -8   4  -5   7 

 -9   2   6  -2   7   5  -4   6  -3   8   3   4   1  -8   6   7  -4  -6 

 -4  -6   3   2   8   2   5   9   2   7   4   6   4   1  -5  -3   8   8 

  8  -5   1  -5   9  -6   8  -3  -4   1  -5   1   4  -3   1  -6   8  -4 

  5   0  -4  -5  -3   6   7   7  -3   9  -6  -5   7  -8  -4  -1  -7  -7 

 -1  -9  -1   4   1   3  -8  -7   6   2  -7   4   8   5  -5  -9   9  -2 

  6   3  -7  -7   2  -4  -6   0  -2  -3   5   0  -1  -6  -2   7   5   5 

 -2   3   4  -6  -4   7   5  -9   2   6  -9  -2  -6   3  -9  -4   2   3 

 -1   2   9   3   8   4   9  -6   4  -3  -8  -4   9  -4   9   3  -1  -8 

  0  -9   8   8   6   5  -4   7  -2  -3   9   9   9  -2   1   8  -9  -3 

 -1   7   0   9  -6  -2  -4   9   3  -8   3   9   9   9   9   7   8   3 

  2  -6   0   6   0  -1   2  -4   4   9  -9   1  -4  -1  -2   3  -4  -1 

 -9  -2  -2   1  -4  -9  -3  -5   7  -7  -8   5   5   0   5  -5  -4  -7 

[8, 5]        [17, 4]        [12, 8]        [6, 16]        [9, 17]        