 -8   3   7  -9   3  -4  -6 -20  -3  -7  -5   8  -9  -4  -2 -42   6   0   8   5 
 -8  -7   6   5  -1  -1  -9   0   0   7   0   6  -3  -3   4   0  -1   4  -9   5 
  3  -4   0   3  -2   7   2   0   0  -3   6  -1   0  -1  -9   0   8   7  -5   0 
  5   1  -7   8   0   3   5   0   0   5   9   9   0  -1   2   0  -6  -9  -7  -3 
 -2   5   5   7   0   2   2   0   0   3   0  -8   0  -5   9   0   8   1   9  -5 
-25   0   0   0   0   0   0   0   0   0   0   0   0   0   0   0   0   0   1  -8 
  0   3   9   3   0   5  -1   0   0  -5   0   0   0   8  -3   0  -1  -6  -6   6 
 -7   4   4   6   0  -7  -1   0   0   9   0  -1   0  -8  -8   0   7  -3  -9  -9 
 -2   7  -3  -3   0   0  -6   0   0  -3   0   5   0  -2  -1   0  -3   7   2  -4 
-21   0   0   0   0   0   0   0   0   0   0   0   0   0   0   0   9   1   5   0 
  4  -1  -8  -2   0   0   4   0   0  -4   0   4   0   5   6   0  -6  -6   6   9 
  0  -7  -9   4   0  -2  -2   0   0  -7   0  -1   0   6   6   0  -7   0   3  -3 
  3   4  -9   0   0   6  -7   0   0   8   0  -3   0  -7  -9   0  -3  -1   0   8 
 -2  -5  -3   3   0   9   0   0   0  -6   0   9   0  -7  -1   0   6  -2  -9   2 
 -7  -7   8   6   0   6   8   0   0  -2   0  -1   0   1   8   0  -2  -1  -7   1 
-39   0   0   0   0   0   0   0   0   0   0   0   0   0   0   0   0   0   0   0 
  6  -2   0  -7   0  -1  -8   0   0  -9   0   9   0   7   8   0   2  -1   0  -2 
  8  -8  -4   1   0   6  -4   0   0  -3   0   7   0  -9   6  -3  -1   8  -3   9 
  8   7   8  -9   0   3   0   0   0   9   0   7   0   2  -5  -6  -2  -2   6  -1 
  4  -4  -3  -8 -32  -7  -4  -4 -31   2  -8   6 -43  -5   6   7   8  -6  -9   3 
