 -2   0   0  -7  -5  -5  -7   5  -6   0 
 -8   0   0   8   0   7  -9   6   4   0 
  6   0   0  -1   0  -8  -7  -3  -3   0 
  1   0   0  -1   0   9   0   5   1   0 
 -9   0   0   0   0   0   0   0   0  -2 
 -6   0   0  -5   0   0   0   0   0 -17 
  8   4   0   0   0   0   0   0   0  -5 
  5  -5   0  -1   0  -1   0  -2   3   0 
  9   6   7  -9   0   5   0  -7  -2   0 
  2  -7  -3  -2 -18   6   3   7   9 -25 
