  1   0   0   9  -1   5  -3   3  -7  -2  -9   4   1  -1  -3   1  -2 -18   8  -1   1   2   0   2   9 
 -8   0   3  -2   7   1   6  -3  -9   2   2   2   8  -7   2  -6  -7   0   1   1   2  -8   5  -2   6 
 -5   6  -5   1  -2  -6  -1   4   4   3   1  -5  -4   4  -8   7  -6   0   3  -4   0   3  -2  -3  -6 
  5   5  -5   1  -6   7   2   6  -8   9  -9  -4  -2   4   6   7  -7   0  -9   3   0   7   6   1  -3 
  8   0   9  -4   6   9   8   2  -9  -1   2   7   7  -2   9   0  -5   0  -9   8   0   7  -9   7   4 
  1   5  -1   0   0   0   0   0   0   0   0   0   0   0   0   0   0   0   0   0   0   1   4  -1  -9 
  2  -7   5   0   9  -1  -9   1   7  -6   4   0   0   0   0   0   0   0   0   0   0   0   0   0  -7 
  9   4  -6   3  -9  -9  -7  -7   5   2   9  -8   0   0   5   0  -6   0   5  -3   0  -4   4   5   5 
  9   5   3  -1  -8   3  -4   6   6   8   3   3   0   5  -1   0   1   0   7  -8   0   0  -8  -9  -5 
 -2  -7  -3  -7   4   8   8   0  -1  -6  -2  -8   0  -9   4   0   3   0  -8  -4   0   1   6   5  -2 
  7   4   4   6   4   8  -9   6  -8   9   1  -9   0   7  -4   0  -8   0  -3  -7   0   1   2  -6   3 
  7   3  -6   1  -2  -2  -5  -8  -7  -9   5   7   0  -1   9   0   6   0   5   0   0   6   1  -8   9 
-49   0   0   0   0   0   0   0   0   0   0   0   0   0   0   0   0   0   3   8   0   1   1   9  -4 
 -9   7   8  -2   8   7   5   3  -5   7   1  -5   0  -7  -2   7   8   0   2   5   0  -9  -5   6   1 
-50   0   0   0   0   0   0   0   0   0   0   0   0   0   0   0   0   0   3   0   0   0  -5  -7   8 
  9  -2   9  -8  -8   0   7   7  -2  -5   3   1   0  -8  -4   9  -1   0  -7  -5   0  -7   2   0   3 
  8   3   9  -7   2   8   9   6   7  -9   7  -6   0   2   1  -8  -5   0   0  -7   0  -4   1   7  -4 
  6  -4  -2  -5   2   7  -6  -5   7  -4   3   2   0  -1  -4  -8  -6   0   6   5   0   4   6   4  -6 
-53   0   0   0   0   0   0   0   0   0   0   0   0   0   0   0   0   0   0   0   0   0   0   0   0 
 -4  -7  -4  -8   3  -3   9  -3   0  -4   4  -8   0  -2   4  -1   2   0   5  -8   0  -5   9  -8  -7 
 -3   9   5   7  -7  -3  -7  -8  -1  -9   4   2   0   7  -8  -7   2   0  -5   9   0   0   1   5  -8 
 -1  -8  -3  -1  -7  -4   5   9  -9   0  -8  -6   0  -6   2   0   4   0  -3   2   0  -1  -9  -7   0 
  9   3   9   0  -2  -8   9  -1  -2  -5  -1   3   0  -2   0  -4  -4   0   5  -1   0  -8  -9  -7  -2 
  2  -4   3   2  -5  -6  -2   7   9   4  -5  -9   0   1  -5   4   9   0  -2  -6   0   3  -1   3  -5 
  8   5  -4   5   7   0  -3   9  -6   5  -6  -3   4   0   0   0   0   0   0   0 -16   0   0   0   0 
